########
#    p #
#      #
#      #
########