########
# ..   #
# oo   #
#      #
########