########
# .. p #
# o   #
#      #
########